NO textures/texture1.xpm
SO textures/texture1.xpm
WE textures/texture2.xpm
EA textures/texture2.xpm

F 220,100,0
C 225,230,255

        1111111111111111111111111
        1000000000110000000000001
        1011000001110000000000001
        1001000000000000000000001
111111111011000001110000000000001
100000000011000001110111111111111
11110111111111011100000010001
11110111111111011101010010001
11000000110101011100000010001
10000000000000001100000010001
10000000000000001101010010001
11000001110101011111011110N0111
11110111 1110101 101111010001
11111111 1111111 111111111111
11111111111111111111111111111111111111111111111
10000000000000000000000000000000000000000000001
10111111111111111111111111111111111111111111101
10100000000000000000000000000000000000000000101
10101111111111111111011111111111111111111111101
10101000000000000001010000000000000000000001101
10101011111111110001010111111111111111110001101
10101010000000010001010100000000000000010001101
10101010111110010001010101111111111110010001101
10101010100010010001010101000000000010010001101
10101010101010010001010101011111110010010001101
10101010101010010001010101010000010010010001101
10101010101010010001010101010110010010010001101
10101010101010010001010101010010010010010001101
10101010101010010001010101010010010010010001101
10000010101010010000010001010010010010010001101
10111110101010011111110101010010010010010001101
10000000101010000000000101010010010010010001101
10111111101011111111110101010010010010010001101
10100000001000000000010101010010010010010001101
10101111111011111110010101010010010010010001101
10101000000010000010010101010010010010010001101
10101011111110110010010101010010010010010001101
10101010000000010010010101010010010010010001101
10101010111111110010010101010010010010010001101
10101010000000000010010101010010010010010001101
10101011111111111110010101010010010010010001101
10101000000000000000010101010010010010010001101
10101111111111111111110101010010010010010001101
10100000000000000000000101010010010010010001101
10111111111111111111111101010010010010010001101
10000000000000000000000001010010010010000000001
11111111111111111111111101010010010011111111101
10000000000000000000000001010010010000000000101
10111111111111111111111111010010011111111110101
10100000000000000000000000010010000000000010101
10101111111111111111111111110011111111111010101
10101000000000000000000000000000000000001010101
10101011111111111111111111111111111111101010101
10101010000000000000000000000000000000101010101
10101010111111111111111111111111111110101010101
10101010100000000000000000000000000010101010101
10101010101111111111111111111111110010101010101
10000000101000000000000000000000010010000000101
11111110101011111111111111111110010011111110101
10000000101010000000000000000010010010000010101
10111111101010111111111111110010010010110010101
10100000001010100000000000010010010010010010101
10101111111010101111111110010010010010010010101
10101000000010101000000010010010010010010010101
10101011111110101011110010010010010010010010101
10101010000000101010010010010010010010010010101
10101010111111101010010010010010010010010010101
10101010100000001010010010010010010010010010101
10101010101111111010010010010010010010010010101
10101010101000000010010010010010010010010010101
10101010101011111110010010010010010010010010101
10101010101010000000010010010010010010010010101
10101010101010111111110010010010010010010010101
10101010101010100000000010010010010010010010101
10101010101010101111111110010010010010010010101
10000000001000101000000000010000010000010000101
11111111101110101011111111110111110111110110101
10000000101010101010000000000100000100000010101
10111110101010101010111111110101110101111110101
10100010101010101010100000010101010101000000101
10101010101010101010101110010101010101011110101
10101010101010101010101010010101010101010010101
10101010101010101010101010010101010101010010101
10101010101010101010101010010101010101010010101
10001000001000001000001000010001000001000010001
10101011101011101011101011110101011101011110101
10101010001010001010001010000101010001010000101
10101010101010101010101010101010101010101010101
10101010101010101010101010101010101010101010101
10000000000000000000000000000000000000000000001
10100000000000000000000000000000000000000000101
10101111111111111111011111111111111111111111101
10101000000000000001010000000000000000000001101
10101011111111110001010111111111111111110001101
10101010000000010001010100000000000000010001101
10101010111110010001010101111111111110010001101
10101010100010010001010101000000000010010001101
10101010101010010001010101011111110010010001101
10101010101010010001010101010000010010010001101
10101010101010010001010101010110010010010001101
10101010101010010001010101010010010010010001101
10101010101010010001010101010010010010010001101
10000010101010010000010001010010010010010001101
10111110101010011111110101010010010010010001101
10000000101010000000000101010010010010010001101
10111111101011111111110101010010010010010001101
10100000001000000000010101010010010010010001101
10101111111011111110010101010010010010010001101
10101000000010000010010101010010010010010001101
10101011111110110010010101010010010010010001101
10101010000000010010010101010010010010010001101
10101010111111110010010101010010010010010001101
10101010000000000010010101010010010010010001101
10101011111111111110010101010010010010010001101
10101000000000000000010101010010010010010001101
10101111111111111111110101010010010010010001101
10100000000000000000000101010010010010010001101
10111111111111111111111101010010010010010001101
10000000000000000000000001010010010010000000001
11111111111111111111111101010010010011111111101
10000000000000000000000001010010010000000000101
10111111111111111111111111010010011111111110101
10100000000000000000000000010010000000000010101
10101111111111111111111111110011111111111010101
10101000000000000000000000000000000000001010101
10101011111111111111111111111111111111101010101
10101010000000000000000000000000000000101010101
10101010111111111111111111111111111110101010101
10101010100000000000000000000000000010101010101
10101010101111111111111111111111110010101010101
10000000101000000000000000000000010010000000101
11111110101011111111111111111110010011111110101
10000000101010000000000000000010010010000010101
10111111101010111111111111110010010010110010101
10100000001010100000000000010010010010010010101
10101111111010101111111110010010010010010010101
10101000000010101000000010010010010010010010101
10101011111110101011110010010010010010010010101
10101010000000101010010010010010010010010010101
10101010111111101010010010010010010010010010101
10101010100000001010010010010010010010010010101
10101010101111111010010010010010010010010010101
10101010101000000010010010010010010010010010101
10101010101011111110010010010010010010010010101
10101010101010000000010010010010010010010010101
10101010101010111111110010010010010010010010101
10101010101010100000000010010010010010010010101
10101010101010101111111110010010010010010010101
10000000001000101000000000010000010000010000101
11111111101110101011111111110111110111110110101
10000000101010101010000000000100000100000010101
10111110101010101010111111110101110101111110101
10100010101010101010100000010101010101000000101
10101010101010101010101110010101010101011110101
10101010101010101010101010010101010101010010101
10101010101010101010101010010101010101010010101
10101010101010101010101010010101010101010010101
10001000001000001000001000010001000001000010001
10101011101011101011101011110101011101011110101
10101010001010001010001010000101010001010000101
10101010101010101010101010101010101010101010101
10101010101010101010101010101010101010101010101
11111111111111111111111111111111111111111111111