F 220,100 ,  0

C 225,  30,0

NO textures/texture1.xpm
SO      textures/texture1.xpm

WE textures/texture2.xpm
EA textures/texture2.xpm




11111111111111111111111111111111  
 1000001000000000110000000000001
 100000101100000111000000000111111111
 100000100100000000000000000000100001
11011111111110110000011100000000000011
10000000001100000111011111111111111111
11010111111111011100000010001
11010111111111011101010010001
11000000110101011100000010001
10000000000000001100000010001
1000000000000011010100100011
100000011101010111110111100111
10N0111 1110101 101111010001
11111111 1111111 111111111111