11111111111                  11111111111   111111111
10000000001                  10000000001   10000000011111 
 10000000001                10000000001    1000000000000011111
  10000000001              10000000001     1000000000000000000111
   10000000001            100000000001     10000000000000000000001
    10000000001          100000000001      100000000000000000000001
     10000000001        100000000001       1000000001111100000000001
      10000000001      100000000001        1000000001    11         1                       
       100000000111111000000000001         1000000001      1         1
        100000000000000000000001111111111111000000001       1        1
         10000000000000000000000000000000000000000001      1         1
        100000000111111000000001111111111111000000001    11          1
       1000000001      1000000001          10000000011111           1
      1000000001        1000000001         10000000000000          1
     1000000001          1000000001        10000000000000         1
    1000000001            1000000001       10000000000000        1
   1000000001              1000000001      10000000000000     111
  1000000001                1000000001     1000000000000011111
 1000000001                  1000000001    10000000011111
11111111111                  11111111111   111111111 
