NO textures/texture1.xpm
SO textures/texture1.xpm
WE textures/texture2.xpm
EA textures/texture2.xpm

F 80,80,80
C 120,120,200

1111111111111
1000000000001
1000000000001
1000000000001
1000000000001
1000000000001
1111111111111
