NO textures/texture1.xpm
SO textures/texture1.xpm
WE textures/texture2.xpm
EA textures/texture2.xpm

F 220,100,0
C 225,30,0

11111111111111111111111111111111  
 1000001000000000110000000000001
 100000101100000111000000000111111111
 100000100100000000000000000000100001
11011111111110110000S11100000000000011
10000000001100000111011111111111111111
11010011111111011100000010001
